.##.....#...............................
.#..#...#######...................####..
.#.##...####..........#####........#####
......###.....#####...#####...########..
.....###.........##...##....#####.......
...#.##.........#####..##...##..........
...#.#....##.....##.......#.....###.....
...#.#....##...##########.###..####.....
...#.#...............##...##.....##.....
####.#...............##.................
.....#......#..#....#####...##....###...
.#####.###..#..#.#..##....####.....##...
...#...#.#..#..###...#..###...####......
.......#.#..#........#.###...##....#####
########.#..#####....#......#####.####..
.###..#.....#...##...#####........#.....
...##......##.....####......########....
..####...###............#####........##.
...........###...#.............######...
....##......##......#.........###.......
##...#..........###.#..#...######..##...
##...#######........#..#...........##...
....#......####.....#..#....#####..##...
...##.........#####.#..##......##.###...
.####...............#..........#..##....
.........####...########...##..##...##..
.................##....###...........###
.................#..........###..##.....
............................#..###..##..
...#####..................##..####..##..
........................####........##..
.......................#####.##.....##..
.......#########.............##...#####.
........########....###########....#..#.
...........#######........#...##...#..##
...............#######....#......#.#.##.
..............########...##..#####...#..
.....###########......##......###..#....
...########................#####...###..
........##............##........#.......