.#####..............
..##.#...###.#######
#..#.#...#.#.####...
##...###.#.#.#......
.#.#.#.....#.#.###.#
.#.#.#.#####.#.###.#
.#.#.#.#...#.#.....#
.#.#.#.#.#.#.#.###..
.#.#.#.#.#.#.#.#.##.
.#.#.#.#.#.#.#.#.##.
.#.#.#.#.#.#.#.#.#..
.#.#.#.#.#.#.#.#.#..
.#.#.#.#.#.#.#...#.#
.#.#.#.#.#.###..##.#
.#.#.#.#.#.....###.#
.#.#.#.#.#...#####.#
.#.#.#.#.#...#####.#
.#.#.#.#.#...#####..
.#.#.#.#.#..#######.
...#.....#..#######.